10;10
##########
#........#
#...#....#
#...#..g.#
#...#....#
#...#....#
#...#..r.#
#........#
#...p....#
##########