20;20
####################
#p.........b.......#
#..#...............#
#..#...#####.......#
#..#............r..#
#..#...............#
#.....#.......###..#
#.....#.......###..#
#..................#
#..................#
#.......g..........#
#..................#
#..#...............#
#..#...#####.......#
#..#...............#
#..#...............#
#.....#...y...###..#
#.....#.......###..#
#..................#
####################