10;5
##########
#p.......#
#.......g#
#.......r#
##########