20;20
####################
####################
#    ###           #
## #     # ####### #
#g ####### #  r    #
# ##     #   ##### #
#    # #   #       #
### ## ##### #### ##
#    # #           #
# # ## # ###### ## #
#   #   p     # #  #
# # # ## #### # # ##
# # #  #   #  # #  #
# # ## # #   ## ## #
# #    # ###       #
#    #       ##### #
## ### # # ##      #
#    # # #    #### #
# #    #    #      #
####################