13;13
#############
#...........#
#.....#.....#
#.....#...g.#
#.....#.....#
#.p...#.....#
#.....#.....#
#.....#.....#
#.....#.....#
#......r....#
#  #######  #
#...........#
#############