20;20
####################
#........##........#
#.##.###.##.###.##.#
#.##.###.##.###.##.#
#...s....c.....s...#
#.##.#.######.#.##.#
#....#...##...#....#
#.##.###.##.###.##.#
#.##.#........#.##.#
#.##.#.##  ##.#.##.#
#......#rgby#......#
#.##.#.######.#.##.#
#.##.#........#.##.#
#......######......#
#.##.#...##...#.##.#
#.##.#.#.##.#.#.##.#
#...s#....p...#s...#
#.######.##.######.#
#..................#
####################