20;20
####################
#....r.............#
#.#####.######.###.#
#.#...#.....#..#...#
#.#.#.#..##.#..#..##
#.#...#..#..#..#...#
#.#......#..#..###.#
#..#####........#.##
#.#.....#######.#.##
#.#.###.#.......g..#
#.#.....#.#####.##.#
#.##.##.#.p.##...#.#
#.#...#...#....#.#.#
#...#.########.#.#.#
#.###..........#...#
#...#.#.##.#####.#.#
#.#...#.#........#.#
#.##.##.#.#.##.#.#.#
#.......#......#...#
####################