10;10
##########
#........#
#...#....#
#.p.#..g.#
#...#....#
#...#....#
#...#..r.#
#........#
#........#
##########