20;20
####################
#..p.............c.#
#.####.######.####.#
#..................#
#.####.######.####.#
#....#..####..#....#
#.##.#.######.#.####
#.##.#..####..#.####
#..s..........g....#
#.###.########.###.#
#.###..........###.#
#.....#.s##..#..y..#
#.##.##.####.##.##.#
#.r.....####...c...#
####.#...##s..#.####
####.#.######.#.####
#....#...b....#....#
#.################.#
#...c..............#
####################