20;20
####################
#.................r#
#.#####.######.##.##
#.#......#.....#...#
#.#.####...###.#.#.#
#.#.#....#...#.#.#.#
#.#...##.###.#...#.#
#...#..#.#...#.#.#.#
#.###..#.#.###.#.#.#
#......#.#.....#...#
#.######.####.##.#.#
#.......p.#...#....#
#.#.###.....#.#.#..#
#.#.#...#.#.#...#..#
#.#...#.#.#.#.#.#..#
#...###.#.#.#...#..#
#.#.......#..#.....#
#.######.###.####..#
#.g................#
####################