20;20
####################
#p..........c......#
#..#...............#
#..#...#####.......#
#..#............r..#
#..#...............#
#.....#.......###..#
#.....#.......###..#
#..................#
#..................#
#.......g..........#
#.............b....#
#..#...............#
#..#...#####.......#
#..#...............#
#.##...............#
#.....#...y...###..#
#.....#.......###..#
#..................#
####################