20;20
####################
#...........c......#
#.#######..........#
#.##...#####.......#
#.##............r..#
#.##...............#
#.#...#.......###..#
#.#...#.......###..#
#.#................#
#..................#
#.#.....g..........#
#.##..........b....#
#.##...............#
#.##...#####.......#
#.##...........p...#
#.##.##............#
#....##...y...###..#
#.#####.......###..#
#..................#
####################